{
    "111": {
        "Serve your sentence": 1,
        "Rise and revolt": 2,
        "Plot a cunning escape": 3
    },
    "113": {},
    "153": {},
    "155": {},
    "157": {},
    "178": {},
    "182": {},
    "503": {},
    "505": {},
    "506": {},
    "523": {},
    "611": {},
    "669": {},
    "670": {},
    "671": {},
    "672": {},
    "673": {},
    "674": {},
    "675": {},
    "676": {},
    "677": {},
    "678": {},
    "923": {},
    "924": {},
    "925": {},
    "926": {},
    "927": {},
    "928": {},
    "1026": {},
    "1308": {}
}
